
0  0  0  0  0  0  0  0  1  0
0  1  0  1  1  0  1  0  0  1
0  1  0  0  0  0  0  0  0  1
0  1  0  1  1  0  0  1  0  1
0  1  1  0  0  0  1  1  0  0
0  0  0  0  1  0  1  1  0  X
0  0  0  0  1  0  0  0  0  0
0  1  0  1  0  0  0  1  0  1
0  0  1  0  0  0  1  0  0  1
F  1  0  1  1  0  1  0  0  0

1  0  0  0  0  0  0  1  0  1
1  F  1  1  0  1  0  0  1  1
1  1  1  0  1  0  1  0  0  1
0  X  0  1  1  0  0  1  0  0
0  1  0  1  0  1  0  1  1  0
0  0  0  1  0  0  0  1  1  0
0  1  1  0  0  1  1  1  0  0
0  0  0  0  1  0  0  0  0  1
1  0  1  0  0  0  1  0  1  0
0  0  0  0  0  0  0  0  0  0

0  0  0  0  0  0  0  0  0  F
0  0  0  0  1  0  1  1  0  1
0  1  1  0  1  0  0  1  1  0
0  1  0  0  0  0  0  1  0  0
0  0  0  0  0  1  0  1  0  0
1  1  X  1  0  0  0  0  1  0
0  0  0  1  1  0  0  0  0  0
1  1  0  0  1  0  0  0  1  0
1  0  1  0  0  1  1  0  1  0
1  0  0  1  0  0  0  0  0  0

1  0  1  0  1  0  1  0  1  0
0  0  0  0  0  0  0  0  0  X
1  0  1  0  1  0  1  0  1  1
1  0  1  0  0  1  0  0  0  0
0  0  0  0  0  0  0  1  1  0
1  0  0  1  0  1  0  1  1  0
0  0  1  0  0  0  1  1  0  0
1  0  0  0  1  1  1  1  1  0
0  0  1  1  1  0  0  0  1  0
1  0  0  F  1  0  1  0  0  0

1  0  0  1  1  0  0  1  1  0
0  1  1  0  0  0  1  0  0  0
1  0  0  0  1  0  0  0  1  0
0  0  0  1  1  1  1  1  0  0
1  1  0  0  0  1  1  1  F  0
0  1  0  1  0  0  0  1  0  0
1  0  0  1  0  1  0  1  0  0
0  0  1  0  0  0  0  1  1  0
1  0  0  1  1  1  0  1  0  0
0  X  1  1  0  1  0  0  0  0